014
045
+---------+------------------------+--------+
|         %                        |     =  |
|         |                        |        |
|         |                        %        |
+------%--+---+--------------------+--%-----+
|             |                             |
|             |                             |
|             |                             |
|             |                             |
+--%----------+                             |
|             |                             |
|             %                             |
|=            |                             |
+-------------+-----------------------------+
