014
045
+---------+---------------+-----------------+
|         %               |              =  |
|         |               |                 |
|         |               |                 |
|         |               |                 |
+---%-----+---------------+-----------------+
|                         |                 |
|                         |                 |
|                         |                 |
+--%----------+------%----+                 |
|             |           |                 |
|             %           |                 |
|=            |           |                 |
+-------------+-----------+-----------------+
